1111111111
1000000001
1010C00X01
11P0000001
1111111111