1111111111
100E000E01
1010C00X01
11P0000001
1111111111