1111111111
1000000E01
1010C00X01
11P000P001
1111111111