1111111111
1000000E01
1010C00X01
1100000001
1111111111