1111111111
1000000E01
1010000X01
11P0000001
1111111111