1111111111
1000001E01
1010C01111
11P0000001
1111111111