111111111111111
1P00001000C00X1
1000110C0000001
1XC00000000C001
10011C0000X0001
1100C0000000X01
100X000111000C1
100000C000110X1
1000C000X001001
1001110C000X001
100C00001111001
1011100C00X0001
10000C000X00001
1000C00111000E1
111111111111111